Bogføringsdato;Bilagsnr.;Eksternt bilagsnr.;Beskrivelse;;;Momsbeløb ;;Debet;;;Kredit;;Saldo
93230 Kundeordre forudbetaling;;;;;;;;;;;;;
;;;;;;;;;;;;;
;;;;;;;;;;;;;0
03/01/2023;1707;;dk;;;0;;;;;800;;-800
04/01/2023;1711;;Nets;;;0;;;;;600;;-1.400,00
05/01/2023;1719;;dk;;;0;;;;;600;;-2.000,00
05/01/2023;1719;;dk;;;0;;;;;400;;-2.400,00
05/01/2023;1719;;dk;;;0;;;;;300;;-2.700,00
06/01/2023;101269;11009;Kundebetaling - Kundeordre CO000422;;;0;;558;;;;;-2.142,00
06/01/2023;1722;;Mobilpay;;;0;;;;;29,2;;-2.171,20
08/01/2023;101270;11010;Kundebetaling - Kundeordre CO000423;;;0;;865;;;;;-1.306,20
09/01/2023;1731;;Mobilpay;;;0;;;;;1.099,25;;-2.405,45
10/01/2023;1733;;dk;;;0;;;;;865;;-3.270,45
10/01/2023;1733;;dk;;;0;;;;;558;;-3.828,45
10/01/2023;1733;;dk;;;0;;;;;200;;-4.028,45
10/01/2023;1733;;dk;;;0;;;;;500;;-4.528,45
10/01/2023;1734;;Nets;;;0;;;;;2.000,00;;-6.528,45
14/01/2023;101273;11012;Kundebetaling - Kundeordre CO000425;;;0;;280;;;;;-6.248,45
14/01/2023;101272;11011;Kundebetaling - Kundeordre CO000424;;;0;;1.000,00;;;;;-5.248,45
15/01/2023;101275;11014;Kundebetaling - Kundeordre CO000427;;;0;;800;;;;;-4.448,45
15/01/2023;101274;11013;Kundebetaling - Kundeordre CO000426;;;0;;358;;;;;-4.090,45
16/01/2023;1742;;Mobilpay;;;0;;;;;64,25;;-4.154,70
16/01/2023;101276;11015;Kundebetaling - Kundeordre CO000428;;;0;;480;;;;;-3.674,70
17/01/2023;101279;11016;Kundebetaling - Kundeordre CO000429;;;0;;144;;;;;-3.530,70
18/01/2023;1746;;Mobilpay;;;0;;;;;755,25;;-4.285,95
18/01/2023;101281;11018;Kundebetaling - Kundeordre CO000431;;;0;;358;;;;;-3.927,95
18/01/2023;101280;11017;Kundebetaling - Kundeordre CO000430;;;0;;100;;;;;-3.827,95
19/01/2023;1752;;Mobilpay;;;0;;;;;3.985,00;;-7.812,95
19/01/2023;101282;11019;Kundebetaling - Kundeordre CO000432;;;0;;189;;;;;-7.623,95
19/01/2023;101285;11020;Kundebetaling - Kundeordre CO000433;;;0;;215;;;;;-7.408,95
21/01/2023;101287;11021;Kundebetaling - Kundeordre CO000434;;;0;;495;;;;;-6.913,95
23/01/2023;101289;11023;Kundebetaling - Kundeordre CO000436;;;0;;173;;;;;-6.740,95
25/01/2023;101292;11025;Kundebetaling - Kundeordre CO000438;;;0;;253;;;;;-6.487,95
25/01/2023;101293;11026;Kundebetaling - Kundeordre CO000439;;;0;;325;;;;;-6.162,95
25/01/2023;101295;11028;Kundebetaling - Kundeordre CO000441;;;0;;230;;;;;-5.932,95
25/01/2023;101296;11029;Kundebetaling - Kundeordre CO000442;;;0;;265;;;;;-5.667,95
25/01/2023;101297;11030;Kundebetaling - Kundeordre CO000443;;;0;;90;;;;;-5.577,95
25/01/2023;101298;11031;Kundebetaling - Kundeordre CO000444;;;0;;395;;;;;-5.182,95
25/01/2023;101300;11033;Kundebetaling - Kundeordre CO000446;;;0;;240;;;;;-4.942,95
25/01/2023;101301;11034;Kundebetaling - Kundeordre CO000447;;;0;;90;;;;;-4.852,95
25/01/2023;101299;11032;Kundebetaling - Kundeordre CO000445;;;0;;300;;;;;-4.552,95
25/01/2023;101294;11027;Kundebetaling - Kundeordre CO000440;;;0;;290;;;;;-4.262,95
26/01/2023;1764;;Mobilpay;;;0;;;;;159,25;;-4.422,20
26/01/2023;101302;11035;Kundebetaling - Kundeordre CO000448;;;0;;600;;;;;-3.822,20
26/01/2023;101305;11037;Kundebetaling - Kundeordre CO000450;;;0;;350;;;;;-3.472,20
26/01/2023;101303;11036;Kundebetaling - Kundeordre CO000449;;;0;;330;;;;;-3.142,20
26/01/2023;101306;11038;Kundebetaling - Kundeordre CO000451;;;0;;145;;;;;-2.997,20
28/01/2023;101308;11040;Kundebetaling - Kundeordre CO000453;;;0;;245;;;;;-2.752,20
29/01/2023;101309;11041;Kundebetaling - Kundeordre CO000454;;;0;;365;;;;;-2.387,20
29/01/2023;101310;11042;Kundebetaling - Kundeordre CO000455;;;0;;320;;;;;-2.067,20
29/01/2023;101311;11043;Kundebetaling - Kundeordre CO000456;;;0;;325;;;;;-1.742,20
30/01/2023;101312;11044;Kundebetaling - Kundeordre CO000457;;;0;;395;;;;;-1.347,20
30/01/2023;101313;11045;Kundebetaling - Kundeordre CO000458;;;0;;300;;;;;-1.047,20
30/01/2023;101318;11047;Kundebetaling - Kundeordre CO000460;;;0;;680;;;;;-367,2
31/01/2023;101319;11048;Kundebetaling - Kundeordre CO000461;;;0;;635;;;;;267,8
31/01/2023;101320;11049;Kundebetaling - Kundeordre CO000462;;;0;;1.405,00;;;;;1.672,80
31/01/2023;101321;11051;Kundebetaling - Kundeordre CO000463;;;0;;85;;;;;1.757,80
31/01/2023;101323;11054;Kundebetaling - Kundeordre CO000465;;;0;;360;;;;;2.117,80
31/01/2023;101322;11053;Kundebetaling - Kundeordre CO000464;;;0;;380;;;;;2.497,80
01/02/2023;101324;11055;Kundebetaling - Kundeordre CO000466;;;0;;558;;;;;3.055,80
01/02/2023;101331;11057;Kundebetaling - Kundeordre CO000468;;;0;;358;;;;;3.413,80
01/02/2023;101330;11056;Kundebetaling - Kundeordre CO000467;;;0;;530;;;;;3.943,80
01/02/2023;1780;;Mobilpay;;;0;;;;;999,25;;2.944,55
01/02/2023;1782;;Dk;;;0;;;;;1.000,00;;1.944,55
01/02/2023;1782;;Dk;;;0;;;;;200;;1.744,55
01/02/2023;1783;;Dk;;;0;;;;;635;;1.109,55
01/02/2023;1783;;Dk;;;0;;;;;300;;809,55
01/02/2023;1783;;Dk;;;0;;;;;395;;414,55
01/02/2023;1783;;Dk;;;0;;;;;320;;94,55
01/02/2023;1783;;Dk;;;0;;;;;365;;-270,45
01/02/2023;1783;;Dk;;;0;;;;;245;;-515,45
01/02/2023;1783;;Dk;;;0;;;;;145;;-660,45
01/02/2023;1783;;Dk;;;0;;;;;350;;-1.010,45
01/02/2023;1783;;Dk;;;0;;;;;330;;-1.340,45
01/02/2023;1783;;Dk;;;0;;;;;600;;-1.940,45
01/02/2023;1783;;Dk;;;0;;;;;90;;-2.030,45
01/02/2023;1783;;Dk;;;0;;;;;240;;-2.270,45
01/02/2023;1783;;Dk;;;0;;;;;395;;-2.665,45
01/02/2023;1783;;Dk;;;0;;;;;90;;-2.755,45
01/02/2023;1783;;Dk;;;0;;;;;265;;-3.020,45
01/02/2023;1783;;Dk;;;0;;;;;230;;-3.250,45
01/02/2023;1783;;Dk;;;0;;;;;253;;-3.503,45
01/02/2023;1783;;Dk;;;0;;;;;173;;-3.676,45
01/02/2023;1783;;Dk;;;0;;;;;495;;-4.171,45
01/02/2023;1783;;Dk;;;0;;;;;215;;-4.386,45
01/02/2023;1783;;Dk;;;0;;;;;189;;-4.575,45
01/02/2023;1783;;Dk;;;0;;;;;358;;-4.933,45
01/02/2023;1783;;Dk;;;0;;;;;100;;-5.033,45
01/02/2023;1783;;Dk;;;0;;;;;144;;-5.177,45
01/02/2023;1783;;Dk;;;0;;;;;800;;-5.977,45
01/02/2023;1783;;Dk;;;0;;;;;358;;-6.335,45
01/02/2023;1783;;Dk;;;0;;;;;280;;-6.615,45
02/02/2023;101334;11061;Kundebetaling - Kundeordre CO000471;;;0;;370;;;;;-6.245,45
02/02/2023;101332;11058;Kundebetaling - Kundeordre CO000469;;;0;;1.090,00;;;;;-5.155,45
02/02/2023;101335;11062;Kundebetaling - Kundeordre CO000472;;;0;;595;;;;;-4.560,45
02/02/2023;101336;11064;Kundebetaling - Kundeordre CO000473;;;0;;260;;;;;-4.300,45
02/02/2023;1790;;Mobilpay;;;0;;;;;10,25;;-4.310,70
02/02/2023;1795;;Nets;;;0;;;;;2.890,00;;-7.200,70
02/02/2023;1796;;dk;;;0;;;;;360;;-7.560,70
02/02/2023;1796;;dk;;;0;;;;;380;;-7.940,70
03/02/2023;101338;11066;Kundebetaling - Kundeordre CO000475;;;0;;555;;;;;-7.385,70
03/02/2023;101339;11067;Kundebetaling - Kundeordre CO000476;;;0;;593;;;;;-6.792,70
03/02/2023;101340;11068;Kundebetaling - Kundeordre CO000477;;;0;;300;;;;;-6.492,70
03/02/2023;1799;;Nets;;;0;;;;;643;;-7.135,70
03/02/2023;1800;;dk;;;0;;;;;530;;-7.665,70
03/02/2023;101343;11069;Kundebetaling - Kundeordre CO000478;;;0;;813;;;;;-6.852,70
03/02/2023;101344;11070;Kundebetaling - Kundeordre CO000479;;;0;;400;;;;;-6.452,70
03/02/2023;101337;11065;Kundebetaling - Kundeordre CO000474;;;0;;800;;;;;-5.652,70
04/02/2023;101346;11072;Kundebetaling - Kundeordre CO000481;;;0;;730;;;;;-4.922,70
04/02/2023;101345;11071;Kundebetaling - Kundeordre CO000480;;;0;;285;;;;;-4.637,70
05/02/2023;101349;11075;Kundebetaling - Kundeordre CO000484;;;0;;130;;;;;-4.507,70
05/02/2023;101347;11073;Kundebetaling - Kundeordre CO000482;;;0;;980;;;;;-3.527,70
05/02/2023;101351;11077;Kundebetaling - Kundeordre CO000486;;;0;;198;;;;;-3.329,70
05/02/2023;101348;11074;Kundebetaling - Kundeordre CO000483;;;0;;263;;;;;-3.066,70
05/02/2023;101350;11076;Kundebetaling - Kundeordre CO000485;;;0;;71;;;;;-2.995,70
06/02/2023;1804;;Dk;;;0;;;;;300;;-3.295,70
06/02/2023;1804;;Dk;;;0;;;;;593;;-3.888,70
06/02/2023;1804;;Dk;;;0;;;;;555;;-4.443,70
06/02/2023;1804;;Dk;;;0;;;;;595;;-5.038,70
06/02/2023;1804;;Dk;;;0;;;;;370;;-5.408,70
06/02/2023;1804;;Dk;;;0;;;;;1.090,00;;-6.498,70
06/02/2023;101352;11078;Kundebetaling - Kundeordre CO000487;;;0;;400;;;;;-6.098,70
06/02/2023;101354;11079;Kundebetaling - Kundeordre CO000488;;;0;;780;;;;;-5.318,70
07/02/2023;101355;11080;Kundebetaling - Kundeordre CO000489;;;0;;240;;;;;-5.078,70
07/02/2023;1809;;Nets;;;0;;;;;260;;-5.338,70
07/02/2023;1810;;Nets;;;0;;;;;358;;-5.696,70
07/02/2023;1813;;DK;;;0;;;;;198;;-5.894,70
07/02/2023;1813;;DK;;;0;;;;;71;;-5.965,70
07/02/2023;1813;;DK;;;0;;;;;130;;-6.095,70
07/02/2023;1813;;DK;;;0;;;;;263;;-6.358,70
07/02/2023;1813;;DK;;;0;;;;;980;;-7.338,70
07/02/2023;1813;;DK;;;0;;;;;730;;-8.068,70
07/02/2023;1813;;DK;;;0;;;;;285;;-8.353,70
07/02/2023;1813;;DK;;;0;;;;;400;;-8.753,70
07/02/2023;1813;;DK;;;0;;;;;813;;-9.566,70
07/02/2023;1813;;DK;;;0;;;;;300;;-9.866,70
07/02/2023;1815;;Mobilpay;;;0;;;;;57,25;;-9.923,95
07/02/2023;101356;11081;Kundebetaling - Kundeordre CO000490;;;0;;208;;;;;-9.715,95
08/02/2023;101359;11083;Kundebetaling - Kundeordre CO000492;;;0;;158;;;;;-9.557,95
08/02/2023;101357;11082;Kundebetaling - Kundeordre CO000491;;;0;;240;;;;;-9.317,95
08/02/2023;1821;;dk;;;0;;;;;240;;-9.557,95
08/02/2023;1821;;dk;;;0;;;;;780;;-10.337,95
08/02/2023;1821;;dk;;;0;;;;;400;;-10.737,95
08/02/2023;1821;;dk;;;0;;;;;325;;-11.062,95
09/02/2023;101360;11084;Kundebetaling - Kundeordre CO000493;;;0;;425;;;;;-10.637,95
09/02/2023;101361;11085;Kundebetaling - Kundeordre CO000494;;;0;;870;;;;;-9.767,95
10/02/2023;101362;11086;Kundebetaling - Kundeordre CO000495;;;0;;200;;;;;-9.567,95
10/02/2023;1831;;Dk;;;0;;;;;158;;-9.725,95
11/02/2023;101395;11120;Kundebetaling - Kundeordre CO000528;;;0;;240;;;;;-9.485,95
11/02/2023;101394;11119;Kundebetaling - Kundeordre CO000527;;;0;;240;;;;;-9.245,95
11/02/2023;101393;11118;Kundebetaling - Kundeordre CO000526;;;0;;240;;;;;-9.005,95
11/02/2023;101392;11117;Kundebetaling - Kundeordre CO000525;;;0;;240;;;;;-8.765,95
11/02/2023;101391;11116;Kundebetaling - Kundeordre CO000524;;;0;;120;;;;;-8.645,95
11/02/2023;101389;11115;Kundebetaling - Kundeordre CO000522;;;0;;240;;;;;-8.405,95
11/02/2023;101390;11114;Kundebetaling - Kundeordre CO000523;;;0;;120;;;;;-8.285,95
11/02/2023;101387;11113;Kundebetaling - Kundeordre CO000520;;;0;;240;;;;;-8.045,95
11/02/2023;101388;11112;Kundebetaling - Kundeordre CO000521;;;0;;120;;;;;-7.925,95
11/02/2023;101385;11111;Kundebetaling - Kundeordre CO000518;;;0;;335;;;;;-7.590,95
11/02/2023;101386;11110;Kundebetaling - Kundeordre CO000519;;;0;;830;;;;;-6.760,95
11/02/2023;101384;11109;Kundebetaling - Kundeordre CO000517;;;0;;240;;;;;-6.520,95
11/02/2023;101382;11108;Kundebetaling - Kundeordre CO000515;;;0;;120;;;;;-6.400,95
11/02/2023;101383;11107;Kundebetaling - Kundeordre CO000516;;;0;;240;;;;;-6.160,95
11/02/2023;101381;11106;Kundebetaling - Kundeordre CO000514;;;0;;120;;;;;-6.040,95
11/02/2023;101380;11105;Kundebetaling - Kundeordre CO000513;;;0;;120;;;;;-5.920,95
11/02/2023;101379;11104;Kundebetaling - Kundeordre CO000512;;;0;;240;;;;;-5.680,95
11/02/2023;101378;11103;Kundebetaling - Kundeordre CO000511;;;0;;120;;;;;-5.560,95
11/02/2023;101377;11102;Kundebetaling - Kundeordre CO000510;;;0;;120;;;;;-5.440,95
11/02/2023;101376;11101;Kundebetaling - Kundeordre CO000509;;;0;;120;;;;;-5.320,95
11/02/2023;101375;11100;Kundebetaling - Kundeordre CO000508;;;0;;240;;;;;-5.080,95
11/02/2023;101374;11099;Kundebetaling - Kundeordre CO000507;;;0;;120;;;;;-4.960,95
11/02/2023;101373;11098;Kundebetaling - Kundeordre CO000506;;;0;;240;;;;;-4.720,95
11/02/2023;101372;11097;Kundebetaling - Kundeordre CO000505;;;0;;240;;;;;-4.480,95
11/02/2023;101370;11094;Kundebetaling - Kundeordre CO000503;;;0;;120;;;;;-4.360,95
11/02/2023;101369;11095;Kundebetaling - Kundeordre CO000502;;;0;;240;;;;;-4.120,95
11/02/2023;101371;11093;Kundebetaling - Kundeordre CO000504;;;0;;120;;;;;-4.000,95
11/02/2023;101366;11092;Kundebetaling - Kundeordre CO000499;;;0;;120;;;;;-3.880,95
11/02/2023;101367;11091;Kundebetaling - Kundeordre CO000500;;;0;;360;;;;;-3.520,95
11/02/2023;101368;11090;Kundebetaling - Kundeordre CO000501;;;0;;240;;;;;-3.280,95
11/02/2023;101364;11089;Kundebetaling - Kundeordre CO000497;;;0;;240;;;;;-3.040,95
11/02/2023;101365;11087;Kundebetaling - Kundeordre CO000498;;;0;;240;;;;;-2.800,95
11/02/2023;101363;11088;Kundebetaling - Kundeordre CO000496;;;0;;120;;;;;-2.680,95
12/02/2023;101403;11128;Kundebetaling - Kundeordre CO000536;;;0;;370;;;;;-2.310,95
12/02/2023;101401;11126;Kundebetaling - Kundeordre CO000534;;;0;;240;;;;;-2.070,95
12/02/2023;101400;11125;Kundebetaling - Kundeordre CO000533;;;0;;240;;;;;-1.830,95
12/02/2023;101399;11124;Kundebetaling - Kundeordre CO000532;;;0;;120;;;;;-1.710,95
12/02/2023;101398;11123;Kundebetaling - Kundeordre CO000531;;;0;;240;;;;;-1.470,95
12/02/2023;101397;11122;Kundebetaling - Kundeordre CO000530;;;0;;240;;;;;-1.230,95
12/02/2023;101396;11121;Kundebetaling - Kundeordre CO000529;;;0;;120;;;;;-1.110,95
12/02/2023;101402;11127;Kundebetaling - Kundeordre CO000535;;;0;;800;;;;;-310,95
13/02/2023;101404;11130;Kundebetaling - Kundeordre CO000537;;;0;;120;;;;;-190,95
13/02/2023;101409;11135;Kundebetaling - Kundeordre CO000541;;;0;;120;;;;;-70,95
13/02/2023;101408;11136;Kundebetaling - Kundeordre CO000540;;;0;;240;;;;;169,05
13/02/2023;101407;11137;Kundebetaling - Kundeordre CO000539;;;0;;120;;;;;289,05
13/02/2023;101410;11138;Kundebetaling - Kundeordre CO000542;;;0;;120;;;;;409,05
13/02/2023;101411;11139;Kundebetaling - Kundeordre CO000543;;;0;;240;;;;;649,05
13/02/2023;101412;11140;Kundebetaling - Kundeordre CO000544;;;0;;120;;;;;769,05
13/02/2023;101413;11141;Kundebetaling - Kundeordre CO000545;;;0;;120;;;;;889,05
13/02/2023;1834;;DK;;;0;;;;;870;;19,05
13/02/2023;1834;;DK;;;0;;;;;425;;-405,95
13/02/2023;101405;11133;Kundebetaling - Kundeordre CO000538;;;0;;120;;;;;-285,95
14/02/2023;101414;11142;Kundebetaling - Kundeordre CO000546;;;0;;240;;;;;-45,95
14/02/2023;101415;11143;Kundebetaling - Kundeordre CO000547;;;0;;120;;;;;74,05
14/02/2023;101417;11144;Kundebetaling - Kundeordre CO000549;;;0;;120;;;;;194,05
14/02/2023;101416;11145;Kundebetaling - Kundeordre CO000548;;;0;;240;;;;;434,05
14/02/2023;101420;11146;Kundebetaling - Kundeordre CO000552;;;0;;120;;;;;554,05
14/02/2023;101418;11148;Kundebetaling - Kundeordre CO000550;;;0;;240;;;;;794,05
14/02/2023;101421;11147;Kundebetaling - Kundeordre CO000553;;;0;;120;;;;;914,05
14/02/2023;101419;11149;Kundebetaling - Kundeordre CO000551;;;0;;240;;;;;1.154,05
14/02/2023;101424;11151;Kundebetaling - Kundeordre CO000556;;;0;;240;;;;;1.394,05
14/02/2023;101423;11150;Kundebetaling - Kundeordre CO000555;;;0;;240;;;;;1.634,05
14/02/2023;101422;11152;Kundebetaling - Kundeordre CO000554;;;0;;240;;;;;1.874,05
14/02/2023;101426;11154;Kundebetaling - Kundeordre CO000558;;;0;;240;;;;;2.114,05
14/02/2023;101425;11153;Kundebetaling - Kundeordre CO000557;;;0;;240;;;;;2.354,05
14/02/2023;101427;11155;Kundebetaling - Kundeordre CO000559;;;0;;240;;;;;2.594,05
14/02/2023;101428;11157;Kundebetaling - Kundeordre CO000560;;;0;;240;;;;;2.834,05
14/02/2023;101429;11158;Kundebetaling - Kundeordre CO000561;;;0;;240;;;;;3.074,05
14/02/2023;101430;11160;Kundebetaling - Kundeordre CO000562;;;0;;120;;;;;3.194,05
14/02/2023;101431;11159;Kundebetaling - Kundeordre CO000563;;;0;;240;;;;;3.434,05
14/02/2023;101434;11161;Kundebetaling - Kundeordre CO000566;;;0;;120;;;;;3.554,05
14/02/2023;101432;11162;Kundebetaling - Kundeordre CO000564;;;0;;240;;;;;3.794,05
14/02/2023;101435;11163;Kundebetaling - Kundeordre CO000567;;;0;;480;;;;;4.274,05
14/02/2023;101433;11164;Kundebetaling - Kundeordre CO000565;;;0;;240;;;;;4.514,05
14/02/2023;101436;11165;Kundebetaling - Kundeordre CO000568;;;0;;120;;;;;4.634,05
14/02/2023;101437;11166;Kundebetaling - Kundeordre CO000569;;;0;;240;;;;;4.874,05
14/02/2023;101438;11167;Kundebetaling - Kundeordre CO000570;;;0;;240;;;;;5.114,05
14/02/2023;101439;11168;Kundebetaling - Kundeordre CO000571;;;0;;120;;;;;5.234,05
14/02/2023;101441;11170;Kundebetaling - Kundeordre CO000573;;;0;;120;;;;;5.354,05
14/02/2023;101443;11172;Kundebetaling - Kundeordre CO000575;;;0;;120;;;;;5.474,05
14/02/2023;101442;11171;Kundebetaling - Kundeordre CO000574;;;0;;120;;;;;5.594,05
14/02/2023;101440;11169;Kundebetaling - Kundeordre CO000572;;;0;;500;;;;;6.094,05
14/02/2023;1837;;Dk;;;0;;;;;370;;5.724,05
15/02/2023;101444;11173;Kundebetaling - Kundeordre CO000576;;;0;;700;;;;;6.424,05
15/02/2023;1840;;DK;;;0;;;;;120;;6.304,05
15/02/2023;1840;;DK;;;0;;;;;240;;6.064,05
15/02/2023;1840;;DK;;;0;;;;;120;;5.944,05
15/02/2023;1840;;DK;;;0;;;;;120;;5.824,05
15/02/2023;1840;;DK;;;0;;;;;240;;5.584,05
15/02/2023;1840;;DK;;;0;;;;;240;;5.344,05
15/02/2023;1840;;DK;;;0;;;;;120;;5.224,05
15/02/2023;1840;;DK;;;0;;;;;240;;4.984,05
15/02/2023;1840;;DK;;;0;;;;;240;;4.744,05
15/02/2023;1840;;DK;;;0;;;;;120;;4.624,05
15/02/2023;1840;;DK;;;0;;;;;240;;4.384,05
15/02/2023;1840;;DK;;;0;;;;;240;;4.144,05
15/02/2023;1840;;DK;;;0;;;;;240;;3.904,05
15/02/2023;1840;;DK;;;0;;;;;120;;3.784,05
15/02/2023;1840;;DK;;;0;;;;;240;;3.544,05
15/02/2023;1840;;DK;;;0;;;;;120;;3.424,05
15/02/2023;1840;;DK;;;0;;;;;240;;3.184,05
15/02/2023;1840;;DK;;;0;;;;;120;;3.064,05
15/02/2023;1840;;DK;;;0;;;;;335;;2.729,05
15/02/2023;1840;;DK;;;0;;;;;830;;1.899,05
15/02/2023;1840;;DK;;;0;;;;;240;;1.659,05
15/02/2023;1840;;DK;;;0;;;;;120;;1.539,05
15/02/2023;1840;;DK;;;0;;;;;240;;1.299,05
15/02/2023;1840;;DK;;;0;;;;;120;;1.179,05
15/02/2023;1840;;DK;;;0;;;;;120;;1.059,05
15/02/2023;1840;;DK;;;0;;;;;240;;819,05
15/02/2023;1840;;DK;;;0;;;;;120;;699,05
15/02/2023;1840;;DK;;;0;;;;;120;;579,05
15/02/2023;1840;;DK;;;0;;;;;120;;459,05
15/02/2023;1840;;DK;;;0;;;;;240;;219,05
15/02/2023;1840;;DK;;;0;;;;;120;;99,05
15/02/2023;1840;;DK;;;0;;;;;240;;-140,95
15/02/2023;1840;;DK;;;0;;;;;240;;-380,95
15/02/2023;1840;;DK;;;0;;;;;120;;-500,95
15/02/2023;1840;;DK;;;0;;;;;120;;-620,95
15/02/2023;1840;;DK;;;0;;;;;120;;-740,95
15/02/2023;1840;;DK;;;0;;;;;360;;-1.100,95
15/02/2023;1840;;DK;;;0;;;;;240;;-1.340,95
15/02/2023;1840;;DK;;;0;;;;;240;;-1.580,95
15/02/2023;1840;;DK;;;0;;;;;200;;-1.780,95
15/02/2023;1840;;DK;;;0;;;;;800;;-2.580,95
15/02/2023;1841;;DK;;;0;;;;;240;;-2.820,95
15/02/2023;1841;;DK;;;0;;;;;240;;-3.060,95
15/02/2023;1841;;DK;;;0;;;;;120;;-3.180,95
15/02/2023;1841;;DK;;;0;;;;;240;;-3.420,95
15/02/2023;1841;;DK;;;0;;;;;480;;-3.900,95
15/02/2023;1841;;DK;;;0;;;;;240;;-4.140,95
15/02/2023;1841;;DK;;;0;;;;;120;;-4.260,95
15/02/2023;1841;;DK;;;0;;;;;120;;-4.380,95
15/02/2023;1841;;DK;;;0;;;;;240;;-4.620,95
15/02/2023;1841;;DK;;;0;;;;;240;;-4.860,95
15/02/2023;1841;;DK;;;0;;;;;240;;-5.100,95
15/02/2023;1841;;DK;;;0;;;;;240;;-5.340,95
15/02/2023;1841;;DK;;;0;;;;;240;;-5.580,95
15/02/2023;1841;;DK;;;0;;;;;240;;-5.820,95
15/02/2023;1841;;DK;;;0;;;;;240;;-6.060,95
15/02/2023;1841;;DK;;;0;;;;;240;;-6.300,95
15/02/2023;1841;;DK;;;0;;;;;240;;-6.540,95
15/02/2023;1841;;DK;;;0;;;;;240;;-6.780,95
15/02/2023;1841;;DK;;;0;;;;;120;;-6.900,95
15/02/2023;1841;;DK;;;0;;;;;120;;-7.020,95
15/02/2023;1841;;DK;;;0;;;;;240;;-7.260,95
15/02/2023;1841;;DK;;;0;;;;;120;;-7.380,95
15/02/2023;1841;;DK;;;0;;;;;120;;-7.500,95
15/02/2023;1841;;DK;;;0;;;;;240;;-7.740,95
15/02/2023;1841;;DK;;;0;;;;;120;;-7.860,95
15/02/2023;1841;;DK;;;0;;;;;120;;-7.980,95
15/02/2023;1841;;DK;;;0;;;;;240;;-8.220,95
15/02/2023;1841;;DK;;;0;;;;;120;;-8.340,95
15/02/2023;101446;11174;Kundebetaling - Kundeordre CO000577;;;0;;173;;;;;-8.167,95
16/02/2023;1843;;Nets;;;0;;;;;1.200,00;;-9.367,95
16/02/2023;1847;;DK;;;0;;;;;120;;-9.487,95
16/02/2023;1847;;DK;;;0;;;;;120;;-9.607,95
16/02/2023;1847;;DK;;;0;;;;;800;;-10.407,95
16/02/2023;1847;;DK;;;0;;;;;208;;-10.615,95
16/02/2023;1847;;DK;;;0;;;;;135;;-10.750,95
16/02/2023;1848;;DK;;;0;;;;;700;;-11.450,95
16/02/2023;1848;;DK;;;0;;;;;120;;-11.570,95
16/02/2023;1848;;DK;;;0;;;;;120;;-11.690,95
17/02/2023;101448;11175;Kundebetaling - Kundeordre CO000578;;;0;;360;;;;;-11.330,95
17/02/2023;1851;;dk;;;0;;;;;173;;-11.503,95
17/02/2023;1854;;Nets;;;0;;;;;500;;-12.003,95
17/02/2023;101449;11176;Kundebetaling - Kundeordre CO000579;;;0;;1.658,00;;;;;-10.345,95
17/02/2023;101450;11177;Kundebetaling - Kundeordre CO000580;;;0;;195;;;;;-10.150,95
17/02/2023;1854;;Nets;;;0;;;;;500;;-10.650,95
17/02/2023;1854;;Nets ført to gange;;;0;;500;;;;;-10.150,95
18/02/2023;101452;11179;Kundebetaling - Kundeordre CO000582;;;0;;245;;;;;-9.905,95
18/02/2023;101451;11178;Kundebetaling - Kundeordre CO000581;;;0;;425;;;;;-9.480,95
19/02/2023;101453;11180;Kundebetaling - Kundeordre CO000583;;;0;;203;;;;;-9.277,95
20/02/2023;101454;11181;Kundebetaling - Kundeordre CO000584;;;0;;558;;;;;-8.719,95
20/02/2023;101457;11182;Kundebetaling - Kundeordre CO000585;;;0;;173;;;;;-8.546,95
20/02/2023;101459;11185;Kundebetaling - Kundeordre CO000587;;;0;;260;;;;;-8.286,95
20/02/2023;101458;11183;Kundebetaling - Kundeordre CO000586;;;0;;200;;;;;-8.086,95
20/02/2023;1860;;dk;;;0;;;;;360;;-8.446,95
20/02/2023;101460;11186;Kundebetaling - Kundeordre CO000588;;;0;;500;;;;;-7.946,95
21/02/2023;101461;11188;Kundebetaling - Kundeordre CO000589;;;0;;580;;;;;-7.366,95
21/02/2023;101463;11189;Kundebetaling - Kundeordre CO000590;;;0;;558;;;;;-6.808,95
21/02/2023;1863;;Dk;;;0;;;;;558;;-7.366,95
21/02/2023;1863;;Dk;;;0;;;;;203;;-7.569,95
21/02/2023;1863;;Dk;;;0;;;;;245;;-7.814,95
21/02/2023;1863;;Dk;;;0;;;;;425;;-8.239,95
22/02/2023;1866;;Nets 2 stk;;;0;;;;;1.853,00;;-10.092,95
22/02/2023;1868;;dk;;;0;;;;;173;;-10.265,95
22/02/2023;101465;11088;Kundebetaling - Kundeordre CO000591;;;0;;120;;;;;-10.145,95
23/02/2023;101470;11192;Kundebetaling - Kundeordre CO000593;;;0;;296;;;;;-9.849,95
23/02/2023;1871;;Mobilpay;;;0;;;;;239,25;;-10.089,20
23/02/2023;1890;;Nets;;;0;;;;;260;;-10.349,20
23/02/2023;1891;;dk;;;0;;;;;558;;-10.907,20
23/02/2023;1891;;dk;;;0;;;;;580;;-11.487,20
23/02/2023;1891;;dk;;;0;;;;;200;;-11.687,20
23/02/2023;101466;11191;Kundebetaling - Kundeordre CO000592;;;0;;600;;;;;-11.087,20
24/02/2023;101471;11193;Kundebetaling - Kundeordre CO000594;;;0;;290;;;;;-10.797,20
25/02/2023;101473;11196;Kundebetaling - Kundeordre CO000596;;;0;;360;;;;;-10.437,20
25/02/2023;101474;11197;Kundebetaling - Kundeordre CO000597;;;0;;500;;;;;-9.937,20
26/02/2023;101475;11198;Kundebetaling - Kundeordre CO000598;;;0;;120;;;;;-9.817,20
27/02/2023;1896;;DK;;;0;;;;;296;;-10.113,20
27/02/2023;101477;11202;Kundebetaling - Kundeordre CO000600;;;0;;560;;;;;-9.553,20
28/02/2023;1899;;DK;;;0;;;;;360;;-9.913,20
28/02/2023;1899;;DK;;;0;;;;;290;;-10.203,20
01/03/2023;101479;11204;Kundebetaling - Kundeordre CO000602;;;0;;660;;;;;-9.543,20
01/03/2023;1915;;Dk;;;0;;;;;560;;-10.103,20
01/03/2023;1915;;DK;;;0;;;;;120;;-10.223,20
01/03/2023;1915;;DK;;;0;;135;;;;;-10.088,20
02/03/2023;101481;11207;Kundebetaling - Kundeordre CO000604;;;0;;300;;;;;-9.788,20
02/03/2023;101480;11206;Kundebetaling - Kundeordre CO000603;;;0;;800;;;;;-8.988,20
03/03/2023;101482;11208;Kundebetaling - Kundeordre CO000605;;;0;;800;;;;;-8.188,20
03/03/2023;101483;11209;Kundebetaling - Kundeordre CO000606;;;0;;195;;;;;-7.993,20
04/03/2023;101486;11211;Kundebetaling - Kundeordre CO000608;;;0;;215;;;;;-7.778,20
05/03/2023;101487;11212;Kundebetaling - Kundeordre CO000609;;;0;;945;;;;;-6.833,20
07/03/2023;101488;11221;Kundebetaling - Kundeordre CO000610;;;0;;425;;;;;-6.408,20
07/03/2023;101490;11213;Kundebetaling - Kundeordre CO000612;;;0;;245;;;;;-6.163,20
07/03/2023;101489;11222;Kundebetaling - Kundeordre CO000611;;;0;;700;;;;;-5.463,20
07/03/2023;1936;;Mobilpay;;;0;;;;;138,25;;-5.601,45
07/03/2023;1937;;DK;;;0;;;;;195;;-5.796,45
07/03/2023;1937;;DK;;;0;;;;;800;;-6.596,45
07/03/2023;1942;;Nets;;;0;;;;;660;;-7.256,45
09/03/2023;1948;;DK;;;0;;425;;;;;-6.831,45
09/03/2023;1948;;DK rett.;;;0;;;;;850;;-7.681,45
15/03/2023;101516;11231;Kundebetaling - Kundeordre CO000633;;;0;;100;;;;;-7.581,45
15/03/2023;101505;11228;Kundebetaling - Kundeordre CO000622;;;0;;1.000,00;;;;;-6.581,45
15/03/2023;101496;11243;Kundebetaling - Kundeordre CO000613;;;0;;360;;;;;-6.221,45
15/03/2023;101518;11260;Kundebetaling - Kundeordre CO000635;;;0;;225;;;;;-5.996,45
15/03/2023;101526;11262;Kundebetaling - Kundeordre CO000643;;;0;;600;;;;;-5.396,45
15/03/2023;101504;11258;Kundebetaling - Kundeordre CO000621;;;0;;200;;;;;-5.196,45
15/03/2023;101502;11253;Kundebetaling - Kundeordre CO000619;;;0;;200;;;;;-4.996,45
15/03/2023;101521;11252;Kundebetaling - Kundeordre CO000638;;;0;;100;;;;;-4.896,45
15/03/2023;101511;11251;Kundebetaling - Kundeordre CO000628;;;0;;100;;;;;-4.796,45
15/03/2023;101503;11248;Kundebetaling - Kundeordre CO000620;;;0;;200;;;;;-4.596,45
15/03/2023;101497;11246;Kundebetaling - Kundeordre CO000614;;;0;;100;;;;;-4.496,45
15/03/2023;101510;11244;Kundebetaling - Kundeordre CO000627;;;0;;100;;;;;-4.396,45
15/03/2023;101514;11240;Kundebetaling - Kundeordre CO000631;;;0;;100;;;;;-4.296,45
15/03/2023;101501;11239;Kundebetaling - Kundeordre CO000618;;;0;;300;;;;;-3.996,45
15/03/2023;101509;11238;Kundebetaling - Kundeordre CO000626;;;0;;100;;;;;-3.896,45
15/03/2023;101498;11237;Kundebetaling - Kundeordre CO000615;;;0;;200;;;;;-3.696,45
15/03/2023;101500;11236;Kundebetaling - Kundeordre CO000617;;;0;;100;;;;;-3.596,45
15/03/2023;101522;11235;Kundebetaling - Kundeordre CO000639;;;0;;200;;;;;-3.396,45
15/03/2023;101508;11234;Kundebetaling - Kundeordre CO000625;;;0;;100;;;;;-3.296,45
15/03/2023;101517;11233;Kundebetaling - Kundeordre CO000634;;;0;;100;;;;;-3.196,45
15/03/2023;101499;11232;Kundebetaling - Kundeordre CO000616;;;0;;100;;;;;-3.096,45
15/03/2023;101513;11223;Kundebetaling - Kundeordre CO000630;;;0;;700;;;;;-2.396,45
15/03/2023;101523;11227;Kundebetaling - Kundeordre CO000640;;;0;;535;;;;;-1.861,45
15/03/2023;101520;11242;Kundebetaling - Kundeordre CO000637;;;0;;1.060,00;;;;;-801,45
15/03/2023;101524;11241;Kundebetaling - Kundeordre CO000641;;;0;;1.000,00;;;;;198,55
15/03/2023;101525;11261;Kundebetaling - Kundeordre CO000642;;;0;;1.200,00;;;;;1.398,55
15/03/2023;101515;11250;Kundebetaling - Kundeordre CO000632;;;0;;1.132,00;;;;;2.530,55
16/03/2023;101529;11263;Kundebetaling - Kundeordre CO000644;;;0;;565;;;;;3.095,55
16/03/2023;101530;11264;Kundebetaling - Kundeordre CO000645;;;0;;560;;;;;3.655,55
17/03/2023;1978;;Dk;;;0;;;;;100;;3.555,55
18/03/2023;101535;11267;Kundebetaling - Kundeordre CO000648;;;0;;560;;;;;4.115,55
18/03/2023;101534;11266;Kundebetaling - Kundeordre CO000647;;;0;;500;;;;;4.615,55
19/03/2023;101537;11269;Kundebetaling - Kundeordre CO000650;;;0;;1.260,00;;;;;5.875,55
19/03/2023;101536;11268;Kundebetaling - Kundeordre CO000649;;;0;;240;;;;;6.115,55
20/03/2023;101540;11272;Kundebetaling - Kundeordre CO000653;;;0;;100;;;;;6.215,55
20/03/2023;101539;11271;Kundebetaling - Kundeordre CO000652;;;0;;200;;;;;6.415,55
20/03/2023;101538;11270;Kundebetaling - Kundeordre CO000651;;;0;;200;;;;;6.615,55
20/03/2023;1982;;DK;;;0;;;;;560;;6.055,55
20/03/2023;1982;;DK;;;0;;;;;565;;5.490,55
20/03/2023;1984;;Mobilpay;;;0;;;;;74,25;;5.416,30
21/03/2023;101547;11275;Kundebetaling - Kundeordre CO000656;;;0;;200;;;;;5.616,30
21/03/2023;101544;11274;Kundebetaling - Kundeordre CO000655;;;0;;660;;;;;6.276,30
21/03/2023;101543;11273;Kundebetaling - Kundeordre CO000654;;;0;;585;;;;;6.861,30
21/03/2023;1986;;DK;;;0;;;;;200;;6.661,30
21/03/2023;1986;;DK;;;0;;;;;1.260,00;;5.401,30
21/03/2023;1986;;DK;;;0;;;;;560;;4.841,30
21/03/2023;1986;;DK;;;0;;;;;1.600,00;;3.241,30
21/03/2023;1986;;DK;;;0;;;;;500;;2.741,30
21/03/2023;1988;;Mobilpay;;;0;;;;;2.855,20;;-113,9
22/03/2023;101551;11279;Kundebetaling - Kundeordre CO000660;;;0;;585;;;;;471,1
22/03/2023;101550;11278;Kundebetaling - Kundeordre CO000659;;;0;;800;;;;;1.271,10
22/03/2023;101548;11276;Kundebetaling - Kundeordre CO000657;;;0;;300;;;;;1.571,10
22/03/2023;101553;11281;Kundebetaling - Kundeordre CO000662;;;0;;100;;;;;1.671,10
22/03/2023;101552;11280;Kundebetaling - Kundeordre CO000661;;;0;;100;;;;;1.771,10
22/03/2023;101549;11277;Kundebetaling - Kundeordre CO000658;;;0;;360;;;;;2.131,10
23/03/2023;101555;11282;Kundebetaling - Kundeordre CO000663;;;0;;100;;;;;2.231,10
23/03/2023;101556;11283;Kundebetaling - Kundeordre CO000664;;;0;;350;;;;;2.581,10
23/03/2023;1998;;Mobilpay;;;0;;;;;59,25;;2.521,85
23/03/2023;101561;11284;Kundebetaling - Kundeordre CO000665;;;0;;435;;;;;2.956,85
24/03/2023;101568;11290;Kundebetaling - Kundeordre CO000670;;;0;;300;;;;;3.256,85
24/03/2023;101562;11285;Kundebetaling - Kundeordre CO000666;;;0;;100;;;;;3.356,85
24/03/2023;101564;11287;Kundebetaling - Kundeordre CO000668;;;0;;1.000,00;;;;;4.356,85
24/03/2023;2002;;DK;;;0;;;;;585;;3.771,85
24/03/2023;2002;;DK;;;0;;1.600,00;;;;;5.371,85
24/03/2023;101563;11286;Kundebetaling - Kundeordre CO000667;;;0;;400;;;;;5.771,85
25/03/2023;101569;11291;Kundebetaling - Kundeordre CO000671;;;0;;230;;;;;6.001,85
27/03/2023;101574;11215;Kundebetaling - Kundeordre CO000673;;;0;;225;;;;;6.226,85
27/03/2023;101575;11217;Kundebetaling - Kundeordre CO000674;;;0;;560;;;;;6.786,85
27/03/2023;101576;11293;Kundebetaling - Kundeordre CO000675;;;0;;285;;;;;7.071,85
27/03/2023;101573;11292;Kundebetaling - Kundeordre CO000672;;;0;;120;;;;;7.191,85
27/03/2023;2007;;DK;;;0;;;;;200;;6.991,85
27/03/2023;2007;;DK;;;0;;;;;245;;6.746,85
28/03/2023;101577;11294;Kundebetaling - Kundeordre CO000676;;;0;;405;;;;;7.151,85
28/03/2023;101579;11296;Kundebetaling - Kundeordre CO000678;;;0;;1.060,00;;;;;8.211,85
28/03/2023;2010;;DK;;;0;;;;;560;;7.651,85
28/03/2023;2010;;DK;;;0;;;;;225;;7.426,85
28/03/2023;2010;;DK;;;0;;;;;945;;6.481,85
28/03/2023;2011;;DK;;;0;;;;;230;;6.251,85
28/03/2023;2011;;DK;;;0;;;;;800;;5.451,85
28/03/2023;2011;;DK;;;0;;;;;300;;5.151,85
28/03/2023;101578;11295;Kundebetaling - Kundeordre CO000677;;;0;;350;;;;;5.501,85
29/03/2023;101583;11297;Kundebetaling - Kundeordre CO000679;;;0;;885;;;;;6.386,85
29/03/2023;101586;11300;Kundebetaling - Kundeordre CO000682;;;0;;302,5;;;;;6.689,35
29/03/2023;101590;11302;Kundebetaling - Kundeordre CO000684;;;0;;290;;;;;6.979,35
29/03/2023;101589;11301;Kundebetaling - Kundeordre CO000683;;;0;;100;;;;;7.079,35
29/03/2023;101592;11219;Kundebetaling - Kundeordre CO000686;;;0;;615;;;;;7.694,35
29/03/2023;101591;11220;Kundebetaling - Kundeordre CO000685;;;0;;593;;;;;8.287,35
29/03/2023;2017;;DK;;;0;;;;;1.060,00;;7.227,35
29/03/2023;2017;;DK;;;0;;;;;405;;6.822,35
29/03/2023;2017;;DK;;;0;;;;;285;;6.537,35
29/03/2023;2017;;DK;;;0;;;;;660;;5.877,35
29/03/2023;2017;;DK;;;0;;;;;1.000,00;;4.877,35
29/03/2023;101584;11298;Kundebetaling - Kundeordre CO000680;;;0;;800;;;;;5.677,35
30/03/2023;101594;11304;Kundebetaling - Kundeordre CO000688;;;0;;405;;;;;6.082,35
30/03/2023;101595;11306;Kundebetaling - Kundeordre CO000689;;;0;;217,5;;;;;6.299,85
30/03/2023;2019;;DK;;;0;;;;;885;;5.414,85
30/03/2023;101593;11303;Kundebetaling - Kundeordre CO000687;;;0;;400;;;;;5.814,85
31/03/2023;101621;11332;Kundebetaling - Kundeordre CO000712;;;0;;240;;;;;6.054,85
31/03/2023;101620;11331;Kundebetaling - Kundeordre CO000711;;;0;;120;;;;;6.174,85
31/03/2023;101619;11329;Kundebetaling - Kundeordre CO000710;;;0;;240;;;;;6.414,85
31/03/2023;101618;11330;Kundebetaling - Kundeordre CO000709;;;0;;120;;;;;6.534,85
31/03/2023;101617;11328;Kundebetaling - Kundeordre CO000708;;;0;;240;;;;;6.774,85
31/03/2023;101616;11327;Kundebetaling - Kundeordre CO000707;;;0;;120;;;;;6.894,85
31/03/2023;101615;11326;Kundebetaling - Kundeordre CO000706;;;0;;360;;;;;7.254,85
31/03/2023;101614;11325;Kundebetaling - Kundeordre CO000705;;;0;;240;;;;;7.494,85
31/03/2023;101613;11323;Kundebetaling - Kundeordre CO000704;;;0;;360;;;;;7.854,85
31/03/2023;101612;11321;Kundebetaling - Kundeordre CO000703;;;0;;240;;;;;8.094,85
31/03/2023;101611;11322;Kundebetaling - Kundeordre CO000702;;;0;;120;;;;;8.214,85
31/03/2023;101610;11320;Kundebetaling - Kundeordre CO000701;;;0;;120;;;;;8.334,85
31/03/2023;101609;11319;Kundebetaling - Kundeordre CO000700;;;0;;240;;;;;8.574,85
31/03/2023;101608;11318;Kundebetaling - Kundeordre CO000699;;;0;;120;;;;;8.694,85
31/03/2023;101605;11317;Kundebetaling - Kundeordre CO000698;;;0;;120;;;;;8.814,85
31/03/2023;101604;11315;Kundebetaling - Kundeordre CO000697;;;0;;240;;;;;9.054,85
31/03/2023;101603;11316;Kundebetaling - Kundeordre CO000696;;;0;;120;;;;;9.174,85
31/03/2023;101602;11313;Kundebetaling - Kundeordre CO000695;;;0;;240;;;;;9.414,85
31/03/2023;101601;11314;Kundebetaling - Kundeordre CO000694;;;0;;240;;;;;9.654,85
31/03/2023;101599;11312;Kundebetaling - Kundeordre CO000692;;;0;;360;;;;;10.014,85
31/03/2023;101597;11307;Kundebetaling - Kundeordre CO000690;;;0;;1.085,00;;;;;11.099,85
31/03/2023;101600;11311;Kundebetaling - Kundeordre CO000693;;;0;;405;;;;;11.504,85
31/03/2023;101598;11308;Kundebetaling - Kundeordre CO000691;;;0;;170;;;;;11.674,85
31/03/2023;2025;;DK;;;0;;;;;405;;11.269,85
31/03/2023;2025;;DK;;;0;;;;;302,5;;10.967,35
31/03/2023;2025;;DK;;;0;;;;;200;;10.767,35
01/04/2023;101622;11334;Kundebetaling - Kundeordre CO000713;;;0;;120;;;;;10.887,35
01/04/2023;101624;11335;Kundebetaling - Kundeordre CO000715;;;0;;240;;;;;11.127,35
01/04/2023;101623;11336;Kundebetaling - Kundeordre CO000714;;;0;;120;;;;;11.247,35
01/04/2023;101625;11337;Kundebetaling - Kundeordre CO000716;;;0;;120;;;;;11.367,35
01/04/2023;101626;11338;Kundebetaling - Kundeordre CO000717;;;0;;120;;;;;11.487,35
02/04/2023;101627;11339;Kundebetaling - Kundeordre CO000718;;;0;;180;;;;;11.667,35
03/04/2023;101628;11340;Kundebetaling - Kundeordre CO000719;;;0;;120;;;;;11.787,35
03/04/2023;101639;11341;Kundebetaling - Kundeordre CO000720;;;0;;200;;;;;11.987,35
03/04/2023;2043;;DK;;;0;;;;;217,5;;11.769,85
03/04/2023;2045;;DK;;;0;;;;;200;;11.569,85
03/04/2023;2045;;DK;;;0;;;;;1.200,00;;10.369,85
03/04/2023;2045;;DK;;;0;;;;;225;;10.144,85
03/04/2023;2045;;DK;;;0;;;;;200;;9.944,85
03/04/2023;2045;;DK;;;0;;;;;200;;9.744,85
03/04/2023;2045;;DK;;;0;;;;;100;;9.644,85
03/04/2023;2045;;DK;;;0;;;;;100;;9.544,85
03/04/2023;2045;;DK;;;0;;;;;200;;9.344,85
03/04/2023;2045;;DK;;;0;;;;;100;;9.244,85
03/04/2023;2045;;DK;;;0;;;;;100;;9.144,85
03/04/2023;2045;;DK;;;0;;;;;360;;8.784,85
03/04/2023;2045;;DK;;;0;;;;;1.060,00;;7.724,85
03/04/2023;2045;;DK;;;0;;;;;1.000,00;;6.724,85
03/04/2023;2045;;DK;;;0;;;;;100;;6.624,85
03/04/2023;2045;;DK;;;0;;;;;300;;6.324,85
03/04/2023;2045;;DK;;;0;;;;;100;;6.224,85
03/04/2023;2045;;DK;;;0;;;;;200;;6.024,85
03/04/2023;2045;;DK;;;0;;;;;100;;5.924,85
03/04/2023;2045;;DK;;;0;;;;;200;;5.724,85
03/04/2023;2045;;DK;;;0;;;;;100;;5.624,85
03/04/2023;2045;;DK;;;0;;;;;100;;5.524,85
03/04/2023;2045;;DK;;;0;;;;;100;;5.424,85
03/04/2023;2045;;DK;;;0;;;;;535;;4.889,85
03/04/2023;2045;;DK;;;0;;;;;700;;4.189,85
03/04/2023;2045;;DK;;;0;;;;;593;;3.596,85
03/04/2023;2045;;DK;;;0;;;;;615;;2.981,85
03/04/2023;2045;;DK;;;0;;;;;215;;2.766,85
03/04/2023;2045;;DK;;;0;;;;;300;;2.466,85
03/04/2023;2045;;DK;;;0;;;;;500;;1.966,85
03/04/2023;2046;;DK;;;0;;;;;120;;1.846,85
03/04/2023;2046;;DK;;;0;;;;;120;;1.726,85
03/04/2023;2046;;DK;;;0;;;;;240;;1.486,85
03/04/2023;2046;;DK;;;0;;;;;120;;1.366,85
03/04/2023;2046;;DK;;;0;;;;;240;;1.126,85
03/04/2023;2046;;DK;;;0;;;;;120;;1.006,85
03/04/2023;2046;;DK;;;0;;;;;240;;766,85
03/04/2023;2046;;DK;;;0;;;;;240;;526,85
03/04/2023;2046;;DK;;;0;;;;;120;;406,85
03/04/2023;2046;;DK;;;0;;;;;360;;46,85
03/04/2023;2046;;DK;;;0;;;;;240;;-193,15
03/04/2023;2046;;DK;;;0;;;;;360;;-553,15
03/04/2023;2046;;DK;;;0;;;;;120;;-673,15
03/04/2023;2046;;DK;;;0;;;;;240;;-913,15
03/04/2023;2046;;DK;;;0;;;;;120;;-1.033,15
03/04/2023;2046;;DK;;;0;;;;;240;;-1.273,15
03/04/2023;2046;;DK;;;0;;;;;120;;-1.393,15
03/04/2023;2046;;DK;;;0;;;;;120;;-1.513,15
03/04/2023;2046;;DK;;;0;;;;;120;;-1.633,15
03/04/2023;2046;;DK;;;0;;;;;240;;-1.873,15
03/04/2023;2046;;DK;;;0;;;;;240;;-2.113,15
03/04/2023;2046;;DK;;;0;;;;;240;;-2.353,15
03/04/2023;2046;;DK;;;0;;;;;360;;-2.713,15
03/04/2023;2046;;DK;;;0;;;;;100;;-2.813,15
03/04/2023;2046;;DK;;;0;;;;;120;;-2.933,15
03/04/2023;2046;;DK;;;0;;;;;300;;-3.233,15
03/04/2023;2046;;DK;;;0;;;;;100;;-3.333,15
03/04/2023;2046;;DK;;;0;;;;;100;;-3.433,15
03/04/2023;2046;;DK;;;0;;;;;100;;-3.533,15
03/04/2023;2046;;DK;;;0;;;;;100;;-3.633,15
03/04/2023;2046;;DK;;;0;;;;;360;;-3.993,15
03/04/2023;2046;;DK;;;0;;;;;585;;-4.578,15
04/04/2023;101640;11342;Kundebetaling - Kundeordre CO000721;;;0;;150;;;;;-4.428,15
04/04/2023;CPM000000015;;DK  6932134 11027        03 04;;;0;;;;;290;;-4.718,15
04/04/2023;CPM000000016;;DK  6932134 11152        03 04;;;0;;120;;;;;-4.598,15
04/04/2023;CPM000000017;;DK  6932134 11283        03 04;;;0;;;;;350;;-4.948,15
04/04/2023;CPM000000018;;DK  6932134 11287        03 04;;;0;;;;;1.000,00;;-5.948,15
04/04/2023;CPM000000019;;DK  6932134 11307        03 04;;;0;;;;;1.085,00;;-7.033,15
04/04/2023;CPM000000020;;DK  6932134 11308        03 04;;;0;;;;;170;;-7.203,15
04/04/2023;CPM000000021;;DK  6932134 11311        03 04;;;0;;;;;405;;-7.608,15
04/04/2023;CPM000000022;;DK  6932134 11338        03 04;;;0;;;;;120;;-7.728,15
04/04/2023;CPM000000023;;DK  6932134 11340        03 04;;;0;;;;;120;;-7.848,15
04/04/2023;CPM000000024;;Nets 0178 8387763;;;0;;;;;290;;-8.138,15
04/04/2023;CPM000000035;;Mobilpay;;;0;;;;;12.712,50;;-20.850,65
05/04/2023;101643;11343;Kundebetaling - Kundeordre CO000722;;;0;;152;;;;;-20.698,65
05/04/2023;CPM000000028;;Nets 0179 8387763;;;0;;;;;3.632,00;;-24.330,65
05/04/2023;CPM000000032;;DK  6932134 11271        04 04;;;0;;200;;;;;-24.130,65
05/04/2023;CPM000000033;;DK  6932134 11341        04 04;;;0;;;;;200;;-24.330,65
07/04/2023;101647;11345;Kundebetaling - Kundeordre CO000724;;;0;;199;;;;;-24.131,65
07/04/2023;101645;11344;Kundebetaling - Kundeordre CO000723;;;0;;545;;;;;-23.586,65
09/04/2023;101650;11348;Kundebetaling - Kundeordre CO000727;;;0;;212;;;;;-23.374,65
09/04/2023;101651;11349;Kundebetaling - Kundeordre CO000728;;;0;;360;;;;;-23.014,65
10/04/2023;101653;11350;Kundebetaling - Kundeordre CO000729;;;0;;455;;;;;-22.559,65
10/04/2023;101654;11351;Kundebetaling - Kundeordre CO000730;;;0;;174;;;;;-22.385,65
11/04/2023;101656;11352;Kundebetaling - Kundeordre CO000732;;;0;;200;;;;;-22.185,65
11/04/2023;101655;11353;Kundebetaling - Kundeordre CO000731;;;0;;200;;;;;-21.985,65
11/04/2023;101657;11354;Kundebetaling - Kundeordre CO000733;;;0;;200;;;;;-21.785,65
11/04/2023;101660;11355;Kundebetaling - Kundeordre CO000734;;;0;;200;;;;;-21.585,65
11/04/2023;CPM000000101;;DK  6932134 11191        10 04;;;0;;;;;600;;-22.185,65
11/04/2023;CPM000000102;;DK  6932134 11266        10 04;;;0;;;;;500;;-22.685,65
11/04/2023;CPM000000103;;DK  6932134 11268        10 04;;;0;;;;;40;;-22.725,65
11/04/2023;CPM000000104;;DK  6932134 11286        10 04;;;0;;;;;400;;-23.125,65
11/04/2023;CPM000000105;;DK  6932134 11295        10 04;;;0;;;;;350;;-23.475,65
11/04/2023;CPM000000106;;DK  6932134 11345        10 04;;;0;;;;;199;;-23.674,65
11/04/2023;CPM000000107;;DK  6932134 11348        10 04;;;0;;;;;212;;-23.886,65
11/04/2023;CPM000000108;;DK  6932134 11349        10 04;;;0;;;;;360;;-24.246,65
12/04/2023;101663;11356;Kundebetaling - Kundeordre CO000735;;;0;;100;;;;;-24.146,65
12/04/2023;CPM000000064;;Nets;;;0;;;;;150;;-24.296,65
12/04/2023;CPM000000069;;DK  6932134 11350        11 04;;;0;;;;;455;;-24.751,65
12/04/2023;CPM000000070;;DK  6932134 11352        11 04;;;0;;;;;200;;-24.951,65
12/04/2023;CPM000000071;;DK  6932134 11353        11 04;;;0;;;;;200;;-25.151,65
12/04/2023;CPM000000072;;DK  6932134 11354        11 04;;;0;;;;;200;;-25.351,65
12/04/2023;CPM000000064;;Nets;;;0;;150;;;;;-25.201,65
12/04/2023;CPM000000064;;Nets;;;0;;;;;150;;-25.351,65
13/04/2023;101668;11357;Kundebetaling - Kundeordre CO000736;;;0;;200;;;;;-25.151,65
13/04/2023;CPM000000077;;Nets;;;0;;;;;1.660,00;;-26.811,65
13/04/2023;CPM000000067;;DK  6932134 11343        12 04;;;0;;;;;152;;-26.963,65
13/04/2023;CPM000000068;;DK  6932134 11351        12 04;;;0;;;;;174;;-27.137,65
13/04/2023;CPM000000069;;DK  6932134 11355        12 04;;;0;;;;;200;;-27.337,65
13/04/2023;CPM000000070;;DK  6932134 11356        12 04;;;0;;;;;100;;-27.437,65
13/04/2023;CPM000000065;;Nets;;;0;;1.660,00;;;;;-25.777,65
13/04/2023;CPM000000065;;Nets;;;0;;;;;1.660,00;;-27.437,65
14/04/2023;101675;11358;Kundebetaling - Kundeordre CO000737;;;0;;200;;;;;-27.237,65
15/04/2023;101676;11359;Kundebetaling - Kundeordre CO000738;;;0;;100;;;;;-27.137,65
16/04/2023;101678;11360;Kundebetaling - Kundeordre CO000739;;;0;;200;;;;;-26.937,65
17/04/2023;101683;11361;Kundebetaling - Kundeordre CO000740;;;0;;100;;;;;-26.837,65
17/04/2023;101685;11362;Kundebetaling - Kundeordre CO000741;;;0;;200;;;;;-26.637,65
17/04/2023;CPM000000084;;DK  6932134 11357        14 04;;;0;;;;;200;;-26.837,65
18/04/2023;101691;11363;Kundebetaling - Kundeordre CO000742;;;0;;100;;;;;-26.737,65
18/04/2023;2055;;dk;;;0;;;;;200;;-26.937,65
18/04/2023;2055;;dk;;;0;;;;;100;;-27.037,65
18/04/2023;2055;;dk;;;0;;;;;200;;-27.237,65
19/04/2023;101692;11364;Kundebetaling - Kundeordre CO000743;;;0;;300;;;;;-26.937,65
19/04/2023;101693;11365;Kundebetaling - Kundeordre CO000744;;;0;;1.000,00;;;;;-25.937,65
19/04/2023;2064;;Dk;;;0;;;;;200;;-26.137,65
19/04/2023;2064;;Dk;;;0;;;;;100;;-26.237,65
19/04/2023;2064;;Dk;;;0;;;;;800;;-27.037,65
20/04/2023;101705;11368;Kundebetaling - Kundeordre CO000746;;;0;;200;;;;;-26.837,65
20/04/2023;CPM000000079;;DK  6932134 11364        19 04;;;0;;;;;300;;-27.137,65
21/04/2023;101712;11371;Kundebetaling - Kundeordre CO000748;;;0;;350;;;;;-26.787,65
21/04/2023;101713;11370;Kundebetaling - Kundeordre CO000749;;;0;;300;;;;;-26.487,65
22/04/2023;101716;11374;Kundebetaling - Kundeordre CO000752;;;0;;382;;;;;-26.105,65
22/04/2023;101717;11376;Kundebetaling - Kundeordre CO000753;;;0;;155;;;;;-25.950,65
23/04/2023;101718;11377;Kundebetaling - Kundeordre CO000754;;;0;;100;;;;;-25.850,65
23/04/2023;101719;11378;Kundebetaling - Kundeordre CO000755;;;0;;345;;;;;-25.505,65
24/04/2023;101721;11379;Kundebetaling - Kundeordre CO000756;;;0;;30;;;;;-25.475,65
24/04/2023;101727;11380;Kundebetaling - Kundeordre CO000757;;;0;;215;;;;;-25.260,65
25/04/2023;101728;11381;Kundebetaling - Kundeordre CO000758;;;0;;100;;;;;-25.160,65
25/04/2023;101729;11383;Kundebetaling - Kundeordre CO000759;;;0;;500;;;;;-24.660,65
25/04/2023;101730;11384;Kundebetaling - Kundeordre CO000760;;;0;;800;;;;;-23.860,65
25/04/2023;101731;11385;Kundebetaling - Kundeordre CO000761;;;0;;560;;;;;-23.300,65
25/04/2023;101739;11387;Kundebetaling - Kundeordre CO000763;;;0;;400;;;;;-22.900,65
25/04/2023;101732;11386;Kundebetaling - Kundeordre CO000762;;;0;;600;;;;;-22.300,65
25/04/2023;101740;11388;Kundebetaling - Kundeordre CO000764;;;0;;917;;;;;-21.383,65
25/04/2023;101741;11389;Kundebetaling - Kundeordre CO000765;;;0;;100;;;;;-21.283,65
26/04/2023;101742;11390;Kundebetaling - Kundeordre CO000766;;;0;;100;;;;;-21.183,65
27/04/2023;101746;11391;Kundebetaling - Kundeordre CO000767;;;0;;90;;;;;-21.093,65
29/04/2023;101753;11393;Kundebetaling - Kundeordre CO000768;;;0;;485;;;;;-20.608,65
29/04/2023;101754;11394;Kundebetaling - Kundeordre CO000769;;;0;;500;;;;;-20.108,65
29/04/2023;101755;11395;Kundebetaling - Kundeordre CO000770;;;0;;300;;;;;-19.808,65
30/04/2023;101756;11396;Kundebetaling - Kundeordre CO000771;;;0;;950;;;;;-18.858,65
30/04/2023;101757;11397;Kundebetaling - Kundeordre CO000772;;;0;;360;;;;;-18.498,65
01/05/2023;101758;11398;Kundebetaling - Kundeordre CO000773;;;0;;1.000,00;;;;;-17.498,65
01/05/2023;101763;11401;Kundebetaling - Kundeordre CO000776;;;0;;225;;;;;-17.273,65
01/05/2023;101759;11399;Kundebetaling - Kundeordre CO000774;;;0;;190;;;;;-17.083,65
02/05/2023;101765;11403;Kundebetaling - Kundeordre CO000778;;;0;;300;;;;;-16.783,65
02/05/2023;101764;11402;Kundebetaling - Kundeordre CO000777;;;0;;400;;;;;-16.383,65
02/05/2023;101766;11404;Kundebetaling - Kundeordre CO000779;;;0;;860;;;;;-15.523,65
02/05/2023;101780;11409;Kundebetaling - Kundeordre CO000783;;;0;;660;;;;;-14.863,65
02/05/2023;101778;11407;Kundebetaling - Kundeordre CO000781;;;0;;240;;;;;-14.623,65
02/05/2023;CPM000000112;;Nets 0185 8387763;;;0;;;;;90;;-14.713,65
02/05/2023;CPM000000125;;DK  6932134 11370        01 05;;;0;;;;;300;;-15.013,65
02/05/2023;CPM000000126;;DK  6932134 11393        01 05;;;0;;;;;485;;-15.498,65
02/05/2023;CPM000000127;;DK  6932134 11394        01 05;;;0;;;;;500;;-15.998,65
02/05/2023;CPM000000128;;DK  6932134 11396        01 05;;;0;;950;;;;;-15.048,65
02/05/2023;CPM000000129;;DK  6932134 11396        01 05;;;0;;;;;950;;-15.998,65
02/05/2023;CPM000000130;;DK  6932134 11397        01 05;;;0;;;;;360;;-16.358,65
02/05/2023;CPM000000131;;DK  6932134 11398        01 05;;;0;;;;;1.000,00;;-17.358,65
03/05/2023;101781;11410;Kundebetaling - Kundeordre CO000784;;;0;;500;;;;;-16.858,65
03/05/2023;101785;11411;Kundebetaling - Kundeordre CO000785;;;0;;385;;;;;-16.473,65
03/05/2023;CPM000000133;;Nets 0186 8387763;;;0;;;;;300;;-16.773,65
03/05/2023;CPM000000142;;DK  6932134 11209        02 05;;;0;;55;;;;;-16.718,65
03/05/2023;CPM000000143;;DK  6932134 11402        02 05;;;0;;;;;400;;-17.118,65
03/05/2023;CPM000000144;;DK  6932134 11403        02 05;;;0;;;;;300;;-17.418,65
04/05/2023;101787;11414;Kundebetaling - Kundeordre CO000786;;;0;;299;;;;;-17.119,65
04/05/2023;101789;11415;Kundebetaling - Kundeordre CO000788;;;0;;1.196,00;;;;;-15.923,65
04/05/2023;101790;11416;Kundebetaling - Kundeordre CO000789;;;0;;598;;;;;-15.325,65
04/05/2023;101788;11417;Kundebetaling - Kundeordre CO000787;;;0;;598;;;;;-14.727,65
04/05/2023;101798;11419;Kundebetaling - Kundeordre CO000790;;;0;;299;;;;;-14.428,65
04/05/2023;101799;11420;Kundebetaling - Kundeordre CO000791;;;0;;598;;;;;-13.830,65
04/05/2023;101801;11422;Kundebetaling - Kundeordre CO000793;;;0;;598;;;;;-13.232,65
04/05/2023;101802;11423;Kundebetaling - Kundeordre CO000794;;;0;;598;;;;;-12.634,65
04/05/2023;101800;11421;Kundebetaling - Kundeordre CO000792;;;0;;500;;;;;-12.134,65
04/05/2023;CPM000000099;;DK  6932134 11399        03 05;;;0;;;;;190;;-12.324,65
04/05/2023;CPM000000100;;DK  6932134 11409        03 05;;;0;;;;;660;;-12.984,65
05/05/2023;101803;11424;Kundebetaling - Kundeordre CO000795;;;0;;299;;;;;-12.685,65
05/05/2023;101804;11425;Kundebetaling - Kundeordre CO000796;;;0;;598;;;;;-12.087,65
05/05/2023;101805;11426;Kundebetaling - Kundeordre CO000797;;;0;;598;;;;;-11.489,65
05/05/2023;101807;11427;Kundebetaling - Kundeordre CO000799;;;0;;299;;;;;-11.190,65
05/05/2023;101808;11429;Kundebetaling - Kundeordre CO000800;;;0;;598;;;;;-10.592,65
05/05/2023;101809;11430;Kundebetaling - Kundeordre CO000801;;;0;;598;;;;;-9.994,65
05/05/2023;101811;11431;Kundebetaling - Kundeordre CO000803;;;0;;598;;;;;-9.396,65
05/05/2023;101810;11432;Kundebetaling - Kundeordre CO000802;;;0;;598;;;;;-8.798,65
05/05/2023;101815;11436;Kundebetaling - Kundeordre CO000807;;;0;;598;;;;;-8.200,65
05/05/2023;101816;11437;Kundebetaling - Kundeordre CO000808;;;0;;598;;;;;-7.602,65
05/05/2023;101814;11438;Kundebetaling - Kundeordre CO000806;;;0;;299;;;;;-7.303,65
05/05/2023;101819;11441;Kundebetaling - Kundeordre CO000811;;;0;;1.196,00;;;;;-6.107,65
05/05/2023;101820;11442;Kundebetaling - Kundeordre CO000812;;;0;;1.196,00;;;;;-4.911,65
05/05/2023;101821;11443;Kundebetaling - Kundeordre CO000813;;;0;;598;;;;;-4.313,65
05/05/2023;101822;11444;Kundebetaling - Kundeordre CO000814;;;0;;299;;;;;-4.014,65
05/05/2023;101823;11445;Kundebetaling - Kundeordre CO000815;;;0;;598;;;;;-3.416,65
05/05/2023;101826;11446;Kundebetaling - Kundeordre CO000816;;;0;;598;;;;;-2.818,65
05/05/2023;101827;11447;Kundebetaling - Kundeordre CO000817;;;0;;1.794,00;;;;;-1.024,65
06/05/2023;101828;11448;Kundebetaling - Kundeordre CO000818;;;0;;598;;;;;-426,65
06/05/2023;101829;11452;Kundebetaling - Kundeordre CO000819;;;0;;897;;;;;470,35
06/05/2023;101830;11453;Kundebetaling - Kundeordre CO000820;;;0;;299;;;;;769,35
06/05/2023;101831;11454;Kundebetaling - Kundeordre CO000821;;;0;;598;;;;;1.367,35
06/05/2023;101832;11455;Kundebetaling - Kundeordre CO000822;;;0;;598;;;;;1.965,35
06/05/2023;101833;11456;Kundebetaling - Kundeordre CO000823;;;0;;299;;;;;2.264,35
06/05/2023;101834;11457;Kundebetaling - Kundeordre CO000824;;;0;;598;;;;;2.862,35
06/05/2023;101835;11458;Kundebetaling - Kundeordre CO000825;;;0;;598;;;;;3.460,35
07/05/2023;101836;11459;Kundebetaling - Kundeordre CO000826;;;0;;598;;;;;4.058,35
07/05/2023;101837;11460;Kundebetaling - Kundeordre CO000827;;;0;;598;;;;;4.656,35
07/05/2023;101838;11461;Kundebetaling - Kundeordre CO000828;;;0;;598;;;;;5.254,35
07/05/2023;101839;11462;Kundebetaling - Kundeordre CO000829;;;0;;598;;;;;5.852,35
07/05/2023;101840;11463;Kundebetaling - Kundeordre CO000830;;;0;;598;;;;;6.450,35
07/05/2023;101841;11464;Kundebetaling - Kundeordre CO000831;;;0;;299;;;;;6.749,35
07/05/2023;101842;11465;Kundebetaling - Kundeordre CO000832;;;0;;1.495,00;;;;;8.244,35
07/05/2023;101843;11466;Kundebetaling - Kundeordre CO000833;;;0;;598;;;;;8.842,35
07/05/2023;101844;11468;Kundebetaling - Kundeordre CO000834;;;0;;1.196,00;;;;;10.038,35
07/05/2023;101845;11469;Kundebetaling - Kundeordre CO000835;;;0;;1.060,00;;;;;11.098,35
08/05/2023;101846;11470;Kundebetaling - Kundeordre CO000836;;;0;;598;;;;;11.696,35
08/05/2023;101849;11472;Kundebetaling - Kundeordre CO000839;;;0;;598;;;;;12.294,35
08/05/2023;101848;11473;Kundebetaling - Kundeordre CO000838;;;0;;598;;;;;12.892,35
08/05/2023;101854;11474;Kundebetaling - Kundeordre CO000840;;;0;;80;;;;;12.972,35
08/05/2023;CPM000000167;;DK  6932134 11410        04 05;;;0;;;;;500;;12.472,35
08/05/2023;CPM000000168;;DK  6932134 11411        04 05;;;0;;;;;385;;12.087,35
08/05/2023;CPM000000207;;DK  6932134 11414        05 05;;;0;;;;;299;;11.788,35
08/05/2023;CPM000000208;;DK  6932134 11415        05 05;;;0;;;;;1.196,00;;10.592,35
08/05/2023;CPM000000209;;DK  6932134 11416        05 05;;;0;;;;;598;;9.994,35
08/05/2023;CPM000000210;;DK  6932134 11417        05 05;;;0;;;;;598;;9.396,35
08/05/2023;CPM000000211;;DK  6932134 11419        05 05;;;0;;;;;299;;9.097,35
08/05/2023;CPM000000212;;DK  6932134 11420        05 05;;;0;;;;;598;;8.499,35
08/05/2023;CPM000000213;;DK  6932134 11421        05 05;;;0;;;;;500;;7.999,35
08/05/2023;CPM000000214;;DK  6932134 11423        05 05;;;0;;;;;598;;7.401,35
08/05/2023;CPM000000215;;DK  6932134 11424        05 05;;;0;;;;;299;;7.102,35
08/05/2023;CPM000000216;;DK  6932134 11425        05 05;;;0;;;;;598;;6.504,35
08/05/2023;CPM000000217;;DK  6932134 11426        05 05;;;0;;;;;598;;5.906,35
08/05/2023;CPM000000218;;DK  6932134 11429        05 05;;;0;;;;;598;;5.308,35
08/05/2023;CPM000000219;;DK  6932134 11430        05 05;;;0;;;;;598;;4.710,35
08/05/2023;CPM000000220;;DK  6932134 11431        05 05;;;0;;;;;598;;4.112,35
08/05/2023;CPM000000221;;DK  6932134 11432        05 05;;;0;;;;;598;;3.514,35
08/05/2023;CPM000000222;;DK  6932134 11436        05 05;;;0;;;;;598;;2.916,35
08/05/2023;CPM000000223;;DK  6932134 11437        05 05;;;0;;;;;598;;2.318,35
08/05/2023;CPM000000224;;DK  6932134 11438        05 05;;;0;;;;;299;;2.019,35
09/05/2023;101855;11476;Kundebetaling - Kundeordre CO000841;;;0;;1.794,00;;;;;3.813,35
09/05/2023;101856;11477;Kundebetaling - Kundeordre CO000842;;;0;;598;;;;;4.411,35
09/05/2023;101857;11478;Kundebetaling - Kundeordre CO000843;;;0;;598;;;;;5.009,35
09/05/2023;101860;11479;Kundebetaling - Kundeordre CO000844;;;0;;598;;;;;5.607,35
09/05/2023;101861;11480;Kundebetaling - Kundeordre CO000845;;;0;;188;;;;;5.795,35
10/05/2023;101862;11481;Kundebetaling - Kundeordre CO000846;;;0;;360;;;;;6.155,35
10/05/2023;101863;11482;Kundebetaling - Kundeordre CO000847;;;0;;1.000,00;;;;;7.155,35
10/05/2023;101864;11484;Kundebetaling - Kundeordre CO000848;;;0;;500;;;;;7.655,35
10/05/2023;101865;11485;Kundebetaling - Kundeordre CO000849;;;0;;1.196,00;;;;;8.851,35
10/05/2023;101872;11488;Kundebetaling - Kundeordre CO000850;;;0;;299;;;;;9.150,35
10/05/2023;101873;11489;Kundebetaling - Kundeordre CO000851;;;0;;405;;;;;9.555,35
10/05/2023;101875;11491;Kundebetaling - Kundeordre CO000853;;;0;;100;;;;;9.655,35
10/05/2023;101876;11492;Kundebetaling - Kundeordre CO000854;;;0;;598;;;;;10.253,35
10/05/2023;101877;11493;Kundebetaling - Kundeordre CO000855;;;0;;205;;;;;10.458,35
10/05/2023;101874;11490;Kundebetaling - Kundeordre CO000852;;;0;;960;;;;;11.418,35
11/05/2023;101878;11494;Kundebetaling - Kundeordre CO000856;;;0;;449;;;;;11.867,35
11/05/2023;101879;11495;Kundebetaling - Kundeordre CO000857;;;0;;500;;;;;12.367,35
11/05/2023;101883;11496;Kundebetaling - Kundeordre CO000858;;;0;;108;;;;;12.475,35
12/05/2023;101885;11498;Kundebetaling - Kundeordre CO000860;;;0;;500;;;;;12.975,35
13/05/2023;101893;11499;Kundebetaling - Kundeordre CO000861;;;0;;685;;;;;13.660,35
14/05/2023;101894;11500;Kundebetaling - Kundeordre CO000862;;;0;;37,5;;;;;13.697,85
14/05/2023;101895;11501;Kundebetaling - Kundeordre CO000863;;;0;;200;;;;;13.897,85
14/05/2023;101897;11502;Kundebetaling - Kundeordre CO000864;;;0;;760;;;;;14.657,85
Kundeordre forudbetaling;;;;;;0;;165.362,50;;;150.704,65;;14.657,85s